00 11 22 33 44 55 66 77 
88 99 00 11 22 33 44 55 
66 77 88 99 00 11 22 33 
44 55 66 77 88 99 00 11 
22 33 44 55 66 77 88 99 
78 dc 61 55 00 00 00 00